
NO ./images/north_wall.xpm


SO   ./images/south_wall.xpm

WE  ./images/west_wall.xpm


F 220,100,0
EA ./images/east_wall.xpm

C 220,100,0


     111111
     10010111111
     10100000001
     1000N111111
     11111
