
NO ./images/north_wall.xpm


SO   ./images/north_wall.xpm

WE  ./images/north_wall.xpm

F 220,100,0
EA ./images/north_wall.xpm

C 220,100,0






         11111111111111111111111
        1000000000110011110000001
        1011000001110000000000001
        1001000000000000000000001
111111111011000001110000000000001
100000000011000001110111111111111
11110111111111011100000010001
11110111111111011101010010001
11000000110101011100000010001
10000000000000001100000010001
10000000000000001101010010001
1100000111010101111101111000111
111101111111S1011101111010001
11111111111111111111111111111
 
11111111111111111111111111111
11111111111111111111111111111
11111111111111111111111111111
11111111111111111111111111111
11111111111111111111111111111
11111111111111111111111111111
11111111111111111111111111111
11111111111111111111111111111
11111111111111111111111111111
11111111111111111111111111111


