
NO ./images/north_wall.xpm


SO   ./images/south_wall.xpm

WE  ./images/west_wall.xpm


F 220,100,0
EA ./images/east_wall.xpm

C 220,100,0


              111111
              100101
              101001
              1100N1
              111011
111111111111111110111111111111111111
111111111111111110111111111111111111
111111111111111110111111111111111111
111111111111111110111111111111111111
111111111111111110111111111111111111
111111111111111110111111111111111111
111111111111111110111111111111111111
111111111111111110111111111111111111
111111111111111110111111111111111111
111111111111111110111111111111111111
111111111111111110111111111111111111
111111111111111110111111111111111111
111111111111111111111111111111111111
